R        1000     1000
NO ./textures/txt_nord.xpm
SO ./textures/txt_sud.xpm

WE ./textures/txt_west.xpm

EA ./textures/txt_est.xpm
S ./textures/plante.xpm

F 220,25,0

C 225,30,0

        1111111111111111111111111
        1000010000110000000000001
        1011000001110000002000001
        1001000000000000000000011
111111111011000001110000000000001
100000000011000001110111111111111
11110111111111011100000010001
11110111111111011101010010201
11000000110101011100000010001
10002000000000011000000102001
10000000000000001101010010001
11000001110101011111011110N0111
11110111 1110101 101111010001
11111111 1111111 11111111111