NO ./txt_nord.xpm
SO ./txt_sud.xpm
WE ./txt_west.xpm
R 730 400
EA ./txt_est.xpm
S ./plante.xpm

F 220,100,0
C 225,30,0
111111111111111111111111111111111
111111111000000000110000000000001
111111111011000001110000002000001
111111111001000000000000000000001
111111111011000001110000000000001
100000000011000001110111111111111
111101111111110111000000100011111
111101111111110111010100100011111
110000001101010111000020200011111
100020000000000011000000000011111
100000000000000011010100100011111
11000001110101011111011110N011111
111101111111010111011110100011111
111111111111111111111111111111111