R 1920 1080
SO ./path_to_the_south_texture
WE ./path_to_the_west_texture
C 225,30,0
EA              ./path_to_the_east_texture
S ./path_to_the_sprite_texture

F 220,100,0

NO ./path_to_the_north_texture

   1111NNN   GHGGHHH11
